NO ./north_texture
SO ./south_texture
WE ./west_texture
EA ./east_texture

F 146,146,147
C 220,000,000

111111111111111111111111
100000000000000000000001
100000000000000000000001
100000000000000000000001
100000000000000000000001
100000000000000000000001
100000000000000000000001
100000111111110000000001
100000100000010000000001
100000100000010000000001
100000100000010000000001
100000100000010000000001
100000100000010000000001
100000100000010000000001
1000001000N0010000000001
100000100000010000000001
100000100000010000000001
100000100000010000000001
100000100000010000000001
100000100000010000000001
100000100000010000000001
100000100000010000000001
100000100000010000000001
100000111111110000000001
100000000000000000000001
100000000000000000000001
100000000000000000000001
100000000000000000000001
100000000000000000000001
100000000000000000000001
100000000000000000000001
100000000000000000000001
100000000000000000000001
100000000000000000000001
100000000000000000000001
100000000000000000000001
111111111111111111111111